AflII	CTTAAG	C|TTAAG	1
AluI	AGCT	AG|CT	2
AvrII	CCTAGG	C|CTAGG	1
BamHI-HF	GGATCC	G|GATCC	1
BfaI	CTAG	C|TAG	1
BmtI-HF	GCTAGC	GCTAG|C	5
BsrGI-HF	TGTACA	T|GTACA	1
DraI	TTTAAA	TTT|AAA	3
HaeIII	GGCC	GG|CC	2
HindIII-HF	AAGCTT	A|AGCTT	1
HpyCH4V	TGCA	TG|CA	2
KpnI-HF	GGTACC	GGTAC|C	5
MfeI-HF	CAATTG	C|AATTG	1
MluCI	AATT	|AATT	0
MscI	TGGCCA	TGG|CCA	3
MseI	TTAA	T|TAA	1
MspI	CCGG	C|CGG	1
NcoI-HF	CCATGG	C|CATGG	1
NdeI	CATATG	CA|TATG	2
NlaIII	CATG	CATG|	4
NsiI-HF	ATGCAT	ATGCA|T	5
PsiI	TTATAA	TTA|TAA	3
PstI-HF	CTGCAG	CTGCA|G	5
PvuII-HF	CAGCTG	CAG|CTG	3
ScaI-HF	AGTACT	AGT|ACT	3
SpeI-HF	ACTAGT	A|CTAGT	1
SphI-HF	GCATGC	GCATG|C	5
SspI-HF	AATATT	AAT|ATT	3
StuI	AGGCCT	AGG|CCT	3
XbaI	TCTAGA	T|CTAGA	1
